[]  [][][][][][][][][][][][][][][][][][][][][][][][][][][][][][][][][][][][][]
[]                                                  []                      []
[][][][][][][][][][][][][][][][][][][][][][][][][]  []  [][][][][][][][][]  []
[]              []                      []      []  []  []              []  []
[]  []  [][][]  []  []  [][][][][][][]  []  []  []  []  [][][]  [][][]  []  []
[]  []  []  []  []  []  []          []      []  []  []      []  []      []  []
[][][]  []  []  []  []  [][][][][]  []  [][][][][]  [][][]  []  [][][][][]  []
[]      []  []  []  []  []          []  []      []      []  []          []  []
[]  [][][]  []  [][][]  []  []  [][][]  []  []  [][][]  []  []  [][][]  []  []
[]  []      []          []  []  []      []  []      []  []  []      []  []  []
[]  [][][]  [][][][][][][]  []  []  [][][]  [][][]  []  []  [][][]  []  []  []
[]      []                  []  []  []      []      []      []  []  []      []
[]  []  []  [][][][][][][][][][][]  []  [][][]  []  [][][][][]  []  [][][][][]
[]  []  []      []      []          []  []      []              []          []
[]  []  [][][]  []  []  []  [][][][][]  []  [][][][][][][][][]  [][][][][]  []
[]  []      []  []  []      []          []  []  []          []      []      []
[]  [][][]  []  []  [][][][][]  [][][][][]  []  []  []  []  [][][]  []  [][][]
[]  []      []              []          []  []      []  []  []      []  []  []
[][][]  [][][]  [][][][][]  [][][][][]  []  [][][]  []  [][][]  [][][]  []  []
[]      []      []      []          []  []      []  []              []  []  []
[]  [][][][][][][]  []  [][][][][][][]  [][][]  [][][][][][][][][][][]  []  []
[]                  []                      []                              []
[][][][][][][][][][][][][][][][][][][][][][][][][][][][][][][][][][][][][]  []