[]  [][][][][][][][][][][][][][][][][][][][][][][][][][][][][][][][][][][][][]
[]              []                                  []                  []  []
[][][][][][][]  []  [][][][][][][][][][][][][][][]  [][][][][]  [][][]  []  []
[]          []      []                          []          []  []  []  []  []
[][][][][]  [][][]  []  [][][][][][][]  [][][][][][][][][]  []  []  []  []  []
[]              []      []          []  []              []      []  []      []
[]  []  [][][][][]  []  []  [][][]  [][][]  []  [][][]  [][][][][]  [][][]  []
[]  []  []          []      []      []      []      []              []      []
[]  []  []  [][][][][][][][][]  []  []  [][][][][]  [][][][][][][][][]  [][][]
[]  []  []              []      []  []          []      []              []  []
[]  []  [][][]  [][][][][]  [][][][][][][][][]  [][][]  []  [][]  [][][][]  []
[]  []  []      []      []  []      []          []  []      []              []
[]  []  []  [][][]  []  []  []  []  []  [][][][][]  [][][][][]  [][][][][]  []
[]  []  []      []  []      []  []      []      []      []      []      []  []
[]  [][][][][]  []  [][][][][]  [][][][][]  []  []  []  [][][]  [][][]  []  []
[]  []      []  []          []      []      []      []      []      []      []
[]  []  []  []  [][][][][]  [][][]  []  [][][][][][][][][]  []  []  []  [][][]
[]  []  []      []      []          []  []  []              []  []  []  []  []
[]  []  [][][][][][][]  [][][][][][][]  []  []  [][][][][][][][][]  []  []  []
[]  []                      []          []      []              []  []      []
[]  [][][][][][][][][][][]  [][][]  [][][]  [][][]  [][][][][]  []  [][][]  []
[]                                                  []              []      []
[][][][][][][][][][][][][][][][][][][][][][][][][][][][][][][][][][][][][]  []