[]  [][][][][][][][][][][][][][][][][][][][][][][][][][][][][][][][][][][][][]
[]                      []                      []                          []
[][][][][][][][][][][]  []  []  [][][][][][][]  []  [][][][][][][][][][][]  []
[]              []  []  []  []  []          []      []                  []  []
[]  [][][][][]  []  []  []  [][][]  [][][]  [][][][][]  [][][][][]  [][][]  []
[]          []      []  []      []      []          []  []      []  []      []
[]  [][][]  [][][][][]  [][][]  [][][]  [][][][][]  [][][]  []  []  []  [][][]
[]      []      []      []          []  []      []      []  []      []      []
[][][]  [][][]  []  [][][]  [][][]  []  []  []  [][][]  []  [][][]  [][][]  []
[]      []  []      []      []      []  []  []      []  []      []      []  []
[]  [][][]  [][][][][]  []  [][][][][]  []  [][][]  []  [][][]  [][][]  []  []
[]      []              []  []          []      []  []  []      []      []  []
[][][]  []  [][][][][][][]  []  [][][][][][][]  []  []  []  [][][]  [][][]  []
[]      []          []      []              []  []      []  []          []  []
[]  [][][][][][][]  [][][][][]  [][][][][][][]  [][][][][]  [][][][][]  []  []
[]      []      []          []  []              []  []          []  []  []  []
[][][]  []  []  [][][][][]  []  []  [][][][][][][]  []  [][][]  []  []  []  []
[]  []  []  []          []      []  []      []          []      []      []  []
[]  []  []  [][][][][]  [][][][][]  [][][]  []  [][][][][]  [][][][][]  []  []
[]  []      []      []          []  []      []      []  []          []  []  []
[]  [][][][][]  [][][][][][][]  []      [][][][][]  []  [][][][][]  [][][]  []
[]                                  []                          []          []
[][][][][][][][][][][][][][][][][][][][][][][][][][][][][][][][][][][][][]  []