[]  [][][][][][][][][]
[]                  []
[][][]  []  [][][][][]
[]      []          []
[]  [][][]  [][][]  []
[]      []      []  []
[]  []  []  []  []  []
[]  []      []      []
[]  [][]  [][][][]  []
[]                  []
[][][][][][][][][]  []